00000000000000000000
..........##########
..........#-########
.^........####|#####
..........##########
...v..[...+#########
..........#####:####
..........##########
..........##########
@.........**********